about : About
Absolutely : Absolute Absoluteness absolute absoluteness absolutely
action : actions actionine Action Actions Actionine
alone : aloneness Aloneness Alone
always : Always
amazing : amazedly amazedness amazed amazing amazes Amazedly Amazedness Amazed Amazing Amazes Amazing
angry : angrier angriest Angrier Angriest Angry
annoying : annoyingly annoyed annoys Annoyingly Annoyed Annoys Annoying
arrested : arrester arrested arresting arrests Aarrester Arrested Arresting Arrests Arrested
away : Away
awful : awfully awfulness Awfully Awfulness
babe : baby babyish babier babiest babyhood babies babied babying Baby Babyish Babe Babier Babiest Babyhood Babies Babied Babying
back : backless backed backing backs Backless Backed Backing Backs Back
bad : badly badness Badly Badness Bad
be : Be
beautiful : beautifully beautifulness Beautifully Beautifulness Beautiful
believe : believer believed believing believes Believer Believed Believing Believes Believe
betcha : Betcha
better : good Good bettered bettering betters Bettered Bettering Betters bested besting bests Bested Besting Bests Best
bewitching : bewitcher bewitched bewitches Bewitcher Bewitched Bewitches Bewitching
big : biggish bigly bigness bigger biggest Biggish Bigly Bigness Bigger Biggest Big
birthday : birthdays Birthdays Birthday
bit : bitted bits Bitted Bits Bit
blow : blew blown blowing blows Blew Blown Blowing Blows Blow
boy : boys boyhood Boy Boys Boyhood
break : broke broken breaking breaks Break Broke Broken Breaking Breaks
breakup : Breakup
burned : burnt burn burning burns Burnt Burn Burning Burns Burned
but : But 
can : could Could Can 
can't : cannot couldn't Couldn't Can't
care : cared caring cares Care Cared Caring Cares
Change : change changed changing changes Changed Changing Changes 
charming : charmless charmingly charmed charm charms Charming Charmless Charmingly Charmed Charm Charms
cheating : cheatingly cheater cheated cheat cheats Cheating Cheatingly Cheater Cheated Cheat Cheats
check : checkable checked checking checks Check Checkable Checked Checking Checks
choking : choked chok chokingly chokes Choked Chok Chokingly Chokes 
Christmas : Christmassy Xmas
cleaned : cleanable cleaner cleanest cleanness clean cleaning cleans Clean Cleanable Cleaner Cleanest Cleanness Cleaned Cleaning Cleans
Come : come came coming comes Came Coming Comes
complaining : complainer complained complaining complains Complaining Complainer Complained Complaining Complains
complete : completive completely completer completest completeness completed completing completes Complete Completive Completely Completer Completest Completeness Completed Completing Completes
complex : complexly complexness Complex Complexly Complexness
complicated : complicatedly complicatedness complicating complicates Complicated Complicatedly Complicatedness Complicating Complicates
Congratulations : Congratulation congratulations congratulations
cool : coolish coolly cooler coolest coolness cooled cooling cools Coolish Coolly Cooler Coolest Coolness Cooled Cooling 
course : 
crap : crapped crapped crapping craps Crap Crapped Crapped Crapping Craps
creepy : creepier creepiest creepiness Creepy Creepier Creepiest Creepiness
crispy : crispier crispiest crispiness Crispy Crispier Crispiest Crispiness
critical : critically criticalness Critical Critically Criticalness
cruel : cruelly crueler crueller cruelest cruellest Cruel Cruelly Crueler Crueller Cruelest Cruellest
crush : crushable crusher crushed crushing crushes Crush Crushable Crusher Crushed Crushing Crushes
cut : cuttable cutting cuts Cut Cuttable Cutting Cuts
cute : cutely cuter cutest cuteness Cute Cutely Cuter Cutest Cuteness
Date : datable dater dated dating dates date Datable Dater Dated Dating Dates 
dead : deader deadest deadness Dead Deader Deadest Deadness
definitive : definitively definitiveness Definitive Definitively Definitiveness
depressed : depressible depressed depressing depresses Depressed Depressible Depressed Depressing Depresses
deserve : deserved deserving deserves Deserve Deserved Deserving Deserves
desperation : desperations Desperations Desperation
Dick : dick
didn't : donot don't didnot Didn't Didnot Donot Don't
died : die dies dying Died Die Dies Dying
ding : dinged dinged dinging dings Ding Dinged Dinged Dinging Dings
dirt : dirty dirtily dirtier dirtiest dirtiness dirtied dirtying dirties Dirt Dirty Dirtily Dirtier Dirtiest Dirtiness Dirtied Dirtying Dirties
disease : diseases Disease Diseases
disgusting : disgustingly disgust disgusted disgusts Disgusting Disgustingly Disgust Disgusted Disgusts
divorce : divorced divorcing divorces Divorce Divorced Divorcing Divorces
do : do's did done doing does Do Do's Did Done Doing Does 
down : downed downing downs Down Downed Downing Downs
embarrassed : embarrassedly embarrass embarrassing embarrasses Embarrassed Embarrassedly Embarrass Embarrassing Embarrasses
enough : Enough
Everybody : everybody
exactly : exactable exactness exacted exacting exacts Exactly Exactable Exactness Exacted Exacting Exacts
Excellent : excellent excellently Excellently
excited : excitedly exciting excites Excited Excitedly Exciting Excites
Excuse : excuse excusable excusably excusableness excused excusing excuses Excusable Excusably Excusableness Excused Excusing Excuses
expensive : expensively expensiveness expensed expensing expenses Expensive Expensively Expensiveness Expensed Expensing Expenses
fabulous : fabulously fabulousness Fabulous Fabulously Fabulousness
failure : failures Failure Failures
fantastic : fantastically fantastical fantasticality fantasies fantasied fantasy fantasying fantasies Fantastic Fantastically Fantastical Fantasticality Fantasies Fantasied Fantasy Fantasying Fantasies
fascinating : fascinatingly fascinated fascinates Fascinating Fascinatingly Fascinated Fascinates
fault : faulted faulting faults Fault Faulted Faulting Faults
fear : fearer feared fearing fears Fear Fearer Feared Fearing Fears
feces : Feces
fight : fightable fightingly fightability fought fighting fights Fight Fightable Fightingly Fightability Fought Fighting Fights
fine : finable finer finest fineness fined fining fines Fine Finable Finer Finest Fineness Fined Fining Fines
fired : fireable firer fired firing fires Fired Fireable Firer Fired Firing Fires
first : First 
forget : forgetter forgot forgotten forgetting forgets Forget Forgetter Forgot Forgotten Forgetting Forgets
freak : freaked freaking freaks Freak Freaked Freaking Freaks 
free : freely freer freest freeness freed freeing frees Free Freely Freer Freest Freeness Freed Freeing Frees
frightening : frighteningly frightener frightened frighten frightens Frightening Frighteningly Frightener Frightened Frighten Frightens
fun : funned funning funs Fun Funned Funning Funs
funny : funnily funnier funniest funniness funnies Funny Funnily Funnier Funniest Funniness Funnies
Game : game gamely gamer gamest gameness gamed gaming games Gamely Gamer Gamest Gameness Gamed Gaming Games
get : getable got gotten getting gets Get Getable Got Gotten Getting Gets
glad : gladly gladder gladdest gladness gladded gladding glads Glad Gladly Gladder Gladdest Gladness Gladded Gladding Glads
glamour : Glamour
go : goes wentgone going Go Goes went Gone Going
God : god
Goodbye : bye bye-bye goodbye Bye Bye-bye
gorgeous : gorgeously gorgeousness Gorgeous Gorgeously Gorgeousness
gosh : Gosh 
grace : graced gracing graces Grace Graced Gracing Graces
grant : grantable granter granted granting grants Grant Grantable Granter Granted Granting Grants
great : greatly greater greatest greatness Great Greatly Greater Greatest Greatness
gross : grossly grosser grossest grossed grossing grosses Gross Grossly Grosser Grossest Grossed Grossing Grosses
guilty : guiltily guiltier guiltiest guiltiness Guilty Guiltily Guiltier Guiltiest Guiltiness
Haha : Ha haha ha
Hanukkah : Hanukah
happen : happened happening happens Happen Happened Happening Happens
happy : happily happier happiest happiness Happy Happily Happier Happiest Happiness
hard : harder hardest Hard Harder Hardest
hate : hater hated hating hates Hate Hater Hated Hating Hates
have : had having has Have Had Having Has
healthy : health healthily healthier healthiest healthiness Healthy Health Healthily Healthier Healthiest Healthiness
hear : hearer heard hearing hears Hear Hearer Heard Hearing Hears
hell : helled helling hells Hell Helled Helling Hells
Hello : hello hullo hellos helloed helloing helloes Hullo Hellos Helloed Helloing Helloes
help : helped helping helps Help Helped Helping Helps
Here : here
hey : Hey
hi : Hi 
hit : hitless hitting hits Hit Hitless Hitting Hits
Hockey : Hockey
Hold : held holding holds hold Held Holding Holds
honey : honeys honeyed honied honeyed honeying Honey Honeys Honeyed Honied Honeyed Honeying
hope : hoper hoped hoping hopes hopefully hopeful hopefulness Hope Hoper Hoped Hoping Hopes Hopefully Hopeful Hopefulness
horrible : horribly horribleness Horrible Horribly Horribleness
how : How
hug : huggable hugger hugged hugging hugs Hug Huggable Hugger Hugged Hugging Hugs
huh : Huh
hurt : hurter hurting hurts Hurt Hurter Hurting Hurts
idiot : idiots Idiot Idiots
imp : imped imping imps Imp Imped Imping Imps
inconvenience : inconvenienced inconveniencing inconveniences Inconvenience Inconvenienced Inconveniencing Inconveniences
incredible : incredibly incredibility Incredible Incredibly Incredibility
interesting : interestingly interested interest interests Interesting Interestingly Interested Interest Interests
invite : invited inviting invites Invite Invited Inviting Invites
jokes : jokingly joked joking joke Jokes Jokingly Joked Joking Joke
jolly : jollily jollier jolliest jolliness jollies jollied jollying Jolly Jollily Jollier Jolliest Jolliness Jollies Jollied Jollying 
judge : judged judged judging judges Judge Judged Judged Judging Judges
juicy : juicily juicier juiciest juiciness Juicy Juicily Juicier Juiciest Juiciness
Just : justly justness just Justly Justness
kidding : Kidding
killing : kill killed killingly kills Killing Kill Killed Killingly Kills
kiss : kissable kissed kissing kisses Kiss Kissable Kissed Kissing Kisses 
kitty : kitties Kitty Kitties
know : knowable knower knew known knowing knows Know Knowable Knower Knew Known Knowing Knows
kook : Kook
last : lastly lasted lasting lasts Last Lastly Lasted Lasting Lasts
late : later latest lateness Late Later Latest Lateness
laugh : laughingly laugher laughed laughing laughs Laugh Laughingly Laugher Laughed Laughing Laughs
like : liked liking likes Like Liked Liking Likes
Listen : listener listened listening listens listen Listener Listened Listening Listens
loathe : loather loathed  loathing loathes Loathe Loather Loathed  Loathing Loathes
look : looked looked looking looks Look Looked Looked Looking Looks
Losing : lost losing loses lose Lost Loses Lose 
love : loved loving loves lovelier loveliest loveliness lovelies lover loverly lovably lovability Love Loved Loving Loves Lovelier Loveliest Loveliness Lovelies Lover Loverly Lovably Lovability
luck : lucked lucking lucks Luck Lucked Lucking Lucks
luminous : luminously luminousness Luminous Luminously Luminousness
mad : maddish madder maddest madded madding mads Mad Maddish Madder Maddest Madded Madding Mads
mama : mamma mom mother Mama Mamma Mom Mother
man : Man
matter : mattered mattering matters Matter Mattered Mattering Matters
Me : me my mine me Me My Mine 
mean : meanly meaner meanest meant meaning means Mean Meanly Meaner Meanest Meant Meaning Means
messing : messed mess messes Messing Messed Mess Messes
met : meetly met meeting meets Met Meetly Met Meeting Meets
midnight : Midnight
miss : missed missing misses Miss Missed Missing Misses
mistake : mistaker mistook mistaken mistaking mistakes Mistake Mistaker Mistook Mistaken Mistaking Mistakes
misunderstood : misunderstand misunderstanding misunderstands Misunderstood Misunderstand Misunderstanding Misunderstands
money : moneys Money Moneys
Monopoly : monopolistic monopolistically monopolism monopolies monopoly Monopolistic Monopolistically Monopolism Monopolies
more : most More Most
moving : movingly moved move moving moves Moving Movingly Moved Move Moving Moves
naked : nakedly nakedness Naked Nakedly Nakedness
nauseous : nauseously Nauseous Nauseously
never : Never
new : newer newest newness New Newer Newest Newness
nice : nicely nicer nicest niceness Nice Nicely Nicer Nicest Niceness
no : noes nope No
noes : Nope
not : Not
nothing : Nothing
noisy : noisily noisier noisiest noisiness Noisy Noisily Noisier Noisiest Noisiness 
Nurse : nurser nursed nursing nurses nurse Nurser Nursed Nursing Nurses
Of : Of
off : offed offing offs Off Offed Offing Offs
Oh : oh
okay : Okey 
on : On
one : One
only : Only
order : ordered ordering orders Order Ordered Ordering Orders
organized : organizer organized organizing organizes Organized Organizer Organized Organizing Organizes
orgasms : orgasm Orgasms Orgasm
out : outed outing outs Out Outed Outing Outs
overrated : overrated overrating overrates Overrated Overrated Overrating Overrates
Ow : ow
owe : owed owing owes Owe Owed Owing Owes
Pacino : 
pact : Pact
pain : pained paining pains Pain Pained Paining Pains
Paolo : 
Party : parties partied partying parties party Parties Partied Partying Parties
passed : passer passed passing passes Passed Passer Passed Passing Passes
passion : Passion
perfect : perfecter perfected perfecting perfects Perfect Perfecter Perfected Perfecting Perfects
pig : pigged pigging pigs Pig Pigged Pigging Pigs
plan : planner planned planning plans Plan Planner Planned Planning Plans
play : playable playability played playing plays Play Playable Playability Played Playing Plays
please : pleaser pleased pleased pleasing pleases Please Pleaser Pleased Pleased Pleasing Pleases
pleasure : pleasureless pleasured pleasuring pleasures Pleasure Pleasureless Pleasured Pleasuring Pleasures
plugs : plugger plugged plugging plug Plugs Plugger Plugged Plugging Plug
present : presentness presented presenting presents Present Presentness Presented Presenting Presents
pressure : pressured pressuring pressures Pressure Pressured Pressuring Pressures
Priesthood : priesthood
problem : problems Problem Problems
pull : puller pulled pulling pulls Pull Puller Pulled Pulling Pulls 
question : questioningly questioner questioned questioning questions Question Questioningly Questioner Questioned Questioning Questions
quiet : quietly quieter quietest quietness quieted quieting quiets Quiet Quietly Quieter Quietest Quietness Quieted Quieting Quiets
ran : run running runs Ran Run Running Runs
ready : readier readiest readiness readied readying readies Ready Readier Readiest Readiness Readied Readying Readies
real : realness reals really Really Real Realness Reals
relieved : relievable reliever relieving relieves Relieved Relievable Reliever Relieving Relieves
respect : respecter respected respecting respects Respect Respecter Respected Respecting Respects
responsible : responsibly responsibleness responsibility responsibilities Responsible Responsibly Responsibleness Responsibility Responsibilities
reward : rewardable rewarder rewarding rewards Reward Rewardable Rewarder Rewarding Rewards
ridiculous : ridiculously ridiculousness Ridiculous Ridiculously Ridiculousness
right : righter rightest righted righting rights Right Righter Rightest Righted Righting Rights
ring :rang ringed rung ringing rings Ring Rang Ringed Rung Ringing Rings
roll : rolled rolling rolls Roll Rolled Rolling Rolls
romantic : romantically romancer romanced romance romancing romances Romantic Romantically Romancer Romanced Romance Romancing Romances
Rome : 
roughhousing : roughhoused roughhouse roughhouses Roughhousing Roughhoused Roughhouse Roughhouses
ruined : ruinable ruiner ruin ruining ruins Ruined Ruinable Ruiner Ruin Ruining Ruins 
sabotaged : sabotage sabotaging sabotages Sabotaged Sabotage Sabotaging Sabotages
sad : sadly sadder saddest sadness Sad Sadly Sadder Saddest Sadness
safe : safely safer safest safeness Safe Safely Safer Safest Safeness
sake : Sake
satisfied : satisfyingly satisfier satisfy satisfying satisfies Satisfied Satisfyingly Satisfier Satisfy Satisfying Satisfies
Saturday : saturday
save : savable saver saved saving saves Save Savable Saver Saved Saving Saves
scary : scarily scarier scariest scariness scared scarer scare scarings scares Scared Scarer Scare Scarings Scares Scary Scarily Scarier Scariest Scariness
Score : scorer scored scoring scores score Scorer Scored Scoring Scores
screwed : screwable screwer screwed screwing screws Screwed Screwable Screwer Screwed Screwing Screws
scum : scummy scummily scummer scummed scumming scums Scum Scummy Scummily Scummer Scummed Scumming Scums
See : saw seen seeing sees see Saw Seen Seeing Sees
sensitive : sensitively sensitiveness Sensitive Sensitively Sensitiveness
Seriously : serious seriousness seriously Serious Seriousness
sex : sexed sexing sexes sexy Sex Sexed Sexing Sexes Sexy
shut : shuts shutting Shut Shuts Shutting 
sick : sicker sickest Sick Sicker Sickest
sign : signer signed signing signs Sign Signer Signed Signing Signs
singing : singable sang sung  sing sings Singing Singable Sang Sung  Sing Sings
slam : slammed slamming slams Slam Slammed Slamming Slams
slumber : slumberingly slumberer slumbered slumbering slumbers Slumber Slumberingly Slumberer Slumbered Slumbering Slumbers
smart : smartly smarter smartest smartness smarted smarting smarts Smart Smartly Smarter Smartest Smartness Smarted Smarting Smarts
Smile : smiley smilingly smiler smiled smiling smiles smile Smiley Smilingly Smiler Smiled Smiling Smiles
smooth : smoothly smoother smoothest smoother smoothed smoothings moothes Smooth Smoothly Smoother Smoothest Smoother Smoothed Smoothings Smoothes
snapped : snap snapping snaps Snapped Snap Snapping Snaps
sorry : sorrily sorrier sorriest sorriness Sorry Sorrily Sorrier Sorriest Sorriness
sour : sourish sourly sourer sourest sourness soured souring sours Sour Sourish Sourly Sourer Sourest Sourness Soured Souring Sours
spasm : spasms Spasms Spasm
squeak : squeaked squeaking squeaks Squeak Squeaked Squeaking Squeaks
star : starred starring stars Star Starred Starring Stars
stop : stoppable stopped stopping stops Stop Stoppable Stopped Stopping Stops
stuck : stick sticking sticks Stuck Stick Sticking Sticks
stunning : stunningly stunned stunning stuns Stunning Stunningly Stunned Stunning Stuns
stupid : stupidly stupider stupidest stupidness Stupid Stupidly Stupider Stupidest Stupidness
suck : sucked sucking sucks Suck Sucked Sucking Sucks: 
superficial : superficially superficiality Superficial Superficially Superficiality
supportive : supportively supportiveness supported supporting supports Supportive Supportively Supportiveness Supported Supporting Supports
sure : surer surest sureness Sure Surer Surest Sureness
surprise : surprising surprised surprisingly surpriser Surprise Surprising Surprised Surprisingly Surpriser 
sweet : sweetly sweeter sweetest sweetness Sweet Sweetly Sweeter Sweetest Sweetness
sweetheart : Sweetheart
sweetie : Sweetie
tackles : tackler tackled tackling Tackles Tackler Tackled Tackling
tell : tellable told telling tells Tell Tellable Told Telling Tells
tender : tenderly tenderer tenderest tenderness tendered tendering tenders Tender Tenderly Tenderer Tenderest Tenderness Tendered Tendering Tenders
terrible : terribly terribleness Terrible Terribly Terribleness
terrific : terrifically Terrific Terrifically
thank : thanked thanking thanks Thank Thanked Thanking Thanks
Thanksgiving : 
that : That
thing : things Thing things
think : thought thinking thinks Think Thought Thinking Thinks
threatening : threateningly threatener threatened threaten threatens Threatening Threateningly Threatener Threatened Threaten Threatens
tickets : ticket ticketed ticketing Tickets Ticket Ticketed Ticketing
together : togetherness Together Togetherness
trouble : troublingly troubler troubled troubling troubles Trouble Troublingly Troubler Troubled Troubling Troubles
true : truer truest trueness trued truing trueing trues True Truer Truest Trueness Trued Truing Trueing Trues
twisted : twistable twistingly twistability twist twisting twists Twisted Twistable Twistingly Twistability Twist Twisting Twists
typical : typically typicalness Typical Typically Typicalness
ugly :  uglily uglier ugliest ugliness uglies Ugly Uglily Uglier Ugliest Ugliness Uglies
unbelievable : unbelievably unbelieving unbelieved unbeliever Unbelievable Unbelievably Unbelieving Unbelieved Unbeliever
unfair : unfairly unfairer unfairest unfairness Unfair Unfairly Unfairer Unfairest Unfairness
until : Until
up : upped upping ups Up Upped Upping Ups
upset : upsettingly upsetter upsetting upsets Upset Upsettingly Upsetter upsetting Upsets
VD : 
violated : violative violator violate violating violates Violated Violative Violator Violate Violating Violates
wait : waited waiting waits Wait Waited Waiting Waits 
want : wantless wanter wanted wanting wants Want Wantless Wanter Wanted Wanting Wants
warm : warmish warmly warmest warmer warmed warming warms Warm Warmish Warmly Warmest Warmer Warmed Warming Warms
waste : wasted wasting wastes Waste Wasted Wasting Wastes
welcome : welcomely welcomeness welcomed welcoming welcomes Welcome Welcomely Welcomeness Welcomed Welcoming Welcomes
well : welled welling wells Well Welled Welling Wells
What :  
Where : 
whip : whipper whipped whipt whipping whips Whip Whipper Whipped Whipt Whipping Whips
Whoa : whoa
Why : Whys why whys
winner : won win winning wins Winner Won Win Winning Wins
wish : wisher wished wishing wishes Wish Wisher Wished Wishing Wishes
with : With
without : Without
wondering : wonderingly wonderer wondered wonder wonders Wondering Wonderingly Wonderer Wondered Wonder Wonders
worried : worrier worries worry worrying worries Worried Worrier Worries Worry Worrying Worries
worst : worse Worst Worse
Wow : wow
wrong : wrongly wronger wronged wronging wrongs Wrong Wrongly Wronger Wronged Wronging Wrongs
yeah : Yeah  
yell : yeller yelled yelling yells Yell Yeller Yelled Yelling Yells
yes : yeses yessed yessing yeses Yes Yeses Yessed Yessing Yeses
Yum : yum